xsj: hia kur
mzp: hur cym
vsq: rps
vzn: gff wwh
evs: pmx
pqr: paw xhq jpb mmh
cde: doo
fmr: qtc wee pcu
zkx: ioc kmp jhf
dac: zwq hug hns
wuw: phy lah
smd: kfd vev ury nyf hbo xpq tvd quk faw jwc mnu
rny: gpc uej
uoj: rps fww bat
jwc: gpo iph
ywo: cfg adw utz
toj: maz rmt wez
cxm: out
zch: ibg zji coc
kfo: ijp opx def wnx
gff: ssl hzu
tcv: mei wgc
ngp: ewu juh pst
obd: lnb jpw caz
gvc: lrt
djr: cfq iwc snx cyi
apy: fdt
lnb: dax rjy
rbz: bjf
mlr: ftl ege jsr juv
rjy: vvl
nel: tpn ynk vqo mre zzw rlb cfb zsz nvj wwt cjf rpq pzz ljs sac sft pde aug opp mri nbn xns acs evs
pym: egw zvn hzk btf
afy: hsg
lkp: isf wxm
umn: kur hia kyw aac
ygi: zog cbk
yzg: iea xmt frv
ryz: out
exv: opx def ijp
hrk: bbc yxp xic
qgp: doo smd wmf
ezw: wnx ijp def opx
aab: vcf
vmi: smd xuq doo
dsn: jmw kag
klp: hxj dwu
ljs: bon
sac: rhu xah
iez: pym sbt krr oif obd ilv nec hls dyd fca yxi wdv awk zkx wcw dqu lab teo klp pgd psj hek bbb yzg
wnx: xyn xex raz toj ikv sho inr yqu rbz mzp jkm dgq mtk sjk tcv uqh hib sww lln lyd ogq ayk
yfa: hty xat
dwr: hsb
coc: nel lrt
ofc: juh pst ewu
jpb: erl unz
mla: doo xuq wmf
puq: feg auw
jvv: fdt
yye: cpd
iph: xxn
bbb: cht
exf: hzi
yxn: bat fww rps
zwp: xop aab zvg ieh gpb wqq oeo tli svw bnb xxx wsf yqz nqv aih cbo hrk wbm nst
cba: wmf smd doo
sov: opx
odd: lgu def wnx
kgu: mhs eml
iea: guf wwh gff
xxn: ijp def opx lgu
jbs: exv
sdd: xuq
vhh: dgv owv
cfg: zfw wqy
ikv: wzf
dek: lvu yfa uzi
zgd: rwb cpf uzi lvu
yhy: ddt cpd ofd
ewu: qgu sxg cjk
hbo: fvp fnl
wgc: gwg vzc
qxe: esw exf
ijp: sjk uqh tcv xex dgq xyn sho hib toj ikv raz yqu ogq inr sww wey jkm mzp ayk rbz
ama: mhs vur
gym: out
esw: hzi fpp exo
gtp: exf
eml: nrq zgd
tpn: xah
haq: smd
ueu: jhw hbw
dsz: ndf iph
hgr: dki szz
fot: tui thn
ehl: fdt nel
mxr: bqd
pej: pnz gfr
gzt: cxm org bez
teg: wfh
tgc: fdt nel lrt
xah: usr heh gle
ljl: idn bzy
bez: out
bjf: xhq pqw
xpn: gjj giw clv efi
bzy: yel wfh
xyy: tbf dwo gym
cel: vzn iea
htq: rka xxu ris
lso: cde nnm
dhk: dss bqd epv
pbj: fww rps
mtk: wzf vlp
dwo: out
suq: qsf bvj
ilv: lnb caz zpa jpw hzf
noc: mkd
ynk: nlk ljl bnf bnz
lvu: gvc
faw: wnc bgs isf wxm
ksv: xuq
din: hwa
aej: ghy esw
ubc: cde nnm vxw
yrs: lab pym wcw krr nec pgd dyd fca psj yzg wdv
vvd: nel fdt
xop: rqv
bgs: rvc reo zgo
lln: mei aht wgc
giw: fww rps bat
cpd: hzj vdn ryz qbt
omh: gdb moi
vgh: nnm
nbn: pmx ado
tqi: out
cvh: vox ffx wcn
ejc: mmu
kyw: out
juh: noc cjk qgu
ieh: yxp xic xma bbc
opp: ukl onr
kur: out
asb: clu vmi
xuq: kct jwc ovq rsq quk faw dsm lkp mnu
mei: vzc gwg xpn
usr: zwp mkd
knd: cyi iwc cfq
dwu: ubc
zmy: ggh jsr juv
zso: wlq bon jrm
fnl: yht cvh dlc koy
hml: mlr ktc
mon: clu xet dxn
pnz: lgu opx def ijp
zji: lrt
gpc: smd
xxx: yif
tqe: fcv
nst: vcf yif
jsr: vrw kny
wpr: omc cjb
exo: zwp you
phg: pst juh jzn ewu
wqy: xyy
epv: ejc fft dyf fot
blp: bzy teg idn
fpp: you mkd zwp
cdj: foc rny
huh: bat
sjk: akr vlv sgj hgr
oif: egw zvn btf hzk
aih: ewo ywo vtd gsy qfk
paw: unz ecn
tui: wnx ijp lgu def opx
cjk: you mkd
pst: noc sxg qgu
tty: ttz pzy dsn
wsf: vtd ywo
mxa: nel lrt fdt
czr: mkd zwp you
xmk: smd doo xuq
ytb: ijp opx
mmu: wnx opx def ijp
juv: haq dip
ozv: civ sov gqc ims
hzu: wmf
muw: wnx def opx ijp
clv: bat
xex: aht mei
clu: wmf smd doo xuq
dyf: mmu tui odd
xic: knd
xat: fdt
hur: ees bwp eor wpo qkv
hzf: dax suq rjy
gpe: aeo rle
dgq: vlv akr hgr sgj
hzj: out
fvp: yht
you: xop tdr zvg aab ieh wfc svw oeo bnb xxx aih cbo yqz nqv hrk wbm
ndf: xxn ezw kfo
aht: hcg gwg vzc
vve: pzy dsn
sho: vkf wez
cfq: ygi
civ: wnx def
tmt: bxq feg
fcv: def lgu
nfx: out
vdn: out
sww: hur gbr
vcf: tmt
lee: tfk
phy: aeo rle zzl
soe: can rfg din gxj
bxq: gzt ydj
yqz: klf
svr: iez zgh yrs trs
ris: oah
yeb: juh ewu
eds: fww
cbk: out
jrx: fww
fft: mmu tui odd
ykc: omh zfw
tch: tmt
oeo: buo klf
zog: out
hck: aeo
esd: smd wmf
zvg: xic bbc
zsz: sio wpr lee
rtn: xet ksv vmi
dof: ddt cpd
xmt: guf
spt: fww
tli: xic xma bbc
bvm: lrt nel
bon: bxm
wzf: hlt fhi twk
qqe: xsj baj umn
psj: caz zpa
twk: ztw uoj hec ulq
bhc: zfw omh
sgj: szz hvn afy
sjo: swc
xpi: mkd zwp you
qzv: ims sov fcv
byw: out
yel: you zwp
gkg: rfg evf can
reo: tqe bqe ozv
wxm: zgo gav rvc
vtf: ajv twk vxj
ogq: mei wgc aht
rpq: yeb
hwa: agg
xpq: abq fnl fvp
erl: jrx ccb
gwg: clv efi
kto: ege ftl ggh
hlt: spt
tdr: mar klf
raz: vlv akr
sbt: kmp jhf gux
egw: hoy
hfi: dae fel tyk
wdv: zvn btf hzk egw ret
qtc: bvm blj nyv
ids: vvd mxa
ssk: zmy mlr
wqq: olb rqv lnw
rwb: gvc hty tgc xat
hbw: yye yhy
vrw: xuq
cht: lso vgh
omc: ggv zwq
rsq: lex dtu
gdb: nfx tbf
xyn: vtf aml
gpb: tch sjo yif
rmt: qgb xei
doo: dhk ijg mnu lkp iok ovq jwc pfx uln hbo nyf dsm tvd xpq dsz rsq xua mxr
teo: lnb caz zpa jpw hzf
pde: bnz bnf blp ljl nlk
pon: esw ghy
hdd: fww bat
mar: mcl wqs yri
wlq: vve tty
zvn: mon asb hoy fog
zwq: zwp mkd
hsb: bat rps fww
jkm: mei
ljr: xxu ris
hxj: lso vgh
nec: frv xmt vzn
guf: hzu mla
mlm: eml mhs
pfx: iph gpo ept
lnw: meg jhw
dax: bvj
dxn: xuq doo wmf smd
abq: koy dlc cvh
vxj: uoj hec spt ulq
nqv: klf mar
nam: ijp lgu def opx
auw: ayb gcg
pqw: ecn unz
bnz: teg
yif: swc puq tmt
cym: bwp qkv wpo
lah: rle zzl
wmf: lkp dhk mnu ijg dux iok quk faw dsm tvd xpq pfx hbo uln ury nyf vev mxr xua rsq dsz
wwt: yeb
ret: fog rtn mon asb
dpb: pmx ado qlw
ktc: ftl
vtd: cfg
owv: umn
wcw: hml
klf: clx mcl
ydp: soe gkg
ajv: hec
fmo: fww
zzw: qec xah
bxm: kni
wqs: dgv
gjj: fww bat
ioc: rny
blj: nel fdt
wee: nyv blj
kny: doo smd wmf
dqu: hzk egw
pic: zhc muw
mkd: aab ieh wsf aih gpb oeo tli svw nst
pgd: xbf
jmw: mkd zwp
ihs: hmq ytb jrd
kmp: foc
ulq: rps
evf: ids irl hwa
gav: qzv tqe bqe ozv
muz: hmq muw ytb zhc
ggh: uyy dip
sft: bon
agg: nel lrt
fep: ljl nlk bnf blp bnz
lab: kmp jhf gux
let: out
iai: fww
xns: yeb phg ngp
fel: vsq fmo
acs: ljl blp bnf
xhq: ecn unz erl
fog: clu xet vmi ksv dxn
gxj: ids
nsj: exf
ffx: ijp def opx wnx
nvj: wlq bon
nrq: lvu cpf
zgh: pym pgd yzg klp bbb hek yxi
zfw: saj gdb
nlk: onn
ofd: ube qbt
xei: dae fel
cbo: olb
efi: fww rps
cjb: zwq
xky: phy lah gpe
zgn: cfq cyi
fdt: zsz zzw mre zso vqo ynk fep evs mbs xns acs sac opp rpq wwt
yhl: xuq
hug: zwp you
qlw: aej pon qxe gtp
ibg: fdt nel
qfk: ykc
pcu: nyv blj jvv bvm
hoy: ksv
jhf: rny foc iae
plv: moi xyy saj
dux: ihs pic
bqd: ejc fft
ydj: cxm org bez
ktn: let cbk zog
hia: out
gqc: opx lgu def
wfh: mkd you
tyk: vsq huh
caz: dax
pmx: gtp nsj qxe aej
wnc: rvc
ssl: xuq smd wmf
ftl: vrw
uln: ept iph
ovq: ndf
gtv: rka
tvd: epv bqd dss
gpo: ezw
nyf: bgs wnc eqk
qgb: gon dae tyk
ury: wcz
plc: bat fww rps
rps: mlm udz git fmr ljr zqd ofu kgu wto faf wuw xky ydp yrl gtv
meg: dof gkt
dlc: ffx vox uzo
def: lln inr yqu jkm ayk xex mtk xyn toj ikv sho hib
jcf: uzo vox wcn ffx
qsf: qgp yhl lew
jpw: dax
dip: wmf smd
hii: jpb mmh pqw paw
cyi: ktn
rqv: hbw
moi: dwo
nnm: smd
hib: hur
ees: fww
rka: lgk zch
gcg: cxm bez org
kni: xpi
mri: jrm bon wlq
uyy: wmf
ims: ijp opx
ube: out
hls: hxj cht dwu
hcg: efi giw
mhs: dek
opx: wey tcv ogq dgq xyn
ttz: kag
clx: qqe dgv owv
gsy: adw ykc
oah: zji coc apy
hsg: rps bat
ege: vrw kny haq uyy
unz: plc ccb qhf
btf: rtn asb
org: out
rle: lrt
wbm: tch
zqd: wee
vlv: afy szz dki hvn
lgu: sww lln inr lyd yqu ogq rbz ayk mzp mtk uqh tcv raz toj ikv sho
zhc: wnx ijp def lgu
mcl: owv
kct: pic klq muz
uen: iwc
fca: xmt vzn
yqu: cym hur
foc: gpc sdd esd
eor: bat fww rps
onr: bww cjb dac
vqo: wpr ukl onr
ecn: ccb plc qhf
irl: mxa vvd
iae: uej esd cba sdd gpc
uej: wmf
svw: ueu rqv
lex: pej jbs
bat: git mlm ofu zqd ljr fmr faf xky ama wuw gtv yrl pyp
emj: xhq mmh paw
can: hwa
akr: dwr afy hvn dki
vur: nrq dek
baj: aac kyw hia
ukl: dac tfk
jrm: vve tty fxg bxm
lew: smd doo
olb: hbw meg
frv: guf wwh
iwc: ygi
rfg: irl hwa ids
zgo: bqe
pyp: lah phy gpe
ewo: bhc adw
vzc: efi giw gjj
wmb: let
thn: ijp opx def
aml: hlt twk vxj fhi
lgk: ibg zji lkx
fww: pyp ydp yrl ama faf kgu fmr htq ofu ljr udz mlm
bnb: qfk ywo
koy: ffx
rhu: heh
dsm: wxm eqk
rvc: bqe ozv qzv
uzi: gvc hty tgc ehl
mbs: xah rhu qec
gfr: ijp def wnx
inr: emj pqr bjf
feg: gcg
ggv: you
vev: bgs
dgv: xsj baj
wez: qgb
sxg: you mkd
yrl: hck lah phy gpe
mre: sio
maz: hfi
xxu: zch lgk
hek: gux cdj jhf kmp
git: fxc
zzl: nel lrt fdt
saj: byw
dae: huh eds vsq yxn
jhw: yhy dof gkt yye
ccb: fww bat
wto: qtc wee pcu
tbf: out
qbt: out
zpa: rjy suq
xbf: ktc mlr kto
qkv: fww
cjf: ofc yeb ngp
jrd: lgu def opx ijp
snx: ygi ktn wmb
ept: kfo
ayb: tqi bez cxm
fxg: dsn pzy kni
uqh: gbr cym
gbr: ees wpo
idn: czr wfh
dss: fft dyf
adw: plv wqy omh
wwh: hzu
mmh: erl
buo: wqs yri vhh clx
gon: fmo yxn
lyd: aml vtf wzf vlp
iok: dtu lex
onn: czr iqd wfh
vlp: fhi vxj
bnf: idn teg onn
ado: nsj qxe
aeo: fdt nel
hzk: fog rtn mon asb
heh: zwp you
pzz: bnf bnz ljl
qec: usr gle heh
qgu: zwp mkd
wcn: wnx def ijp
swc: bxq auw feg
dtu: jbs pej
isf: zgo
yxi: ioc gux cdj kmp jhf
iqd: zwp mkd
vox: wnx lgu opx
wey: maz rmt wez
xzw: xvf
faf: fxc soe gkg
xua: xzw
vxw: wmf xuq doo
ddt: vdn ryz ube
trs: lab oif hls sbt wcw psj teo cel wdv yxi
krr: btf hzk zvn
bvj: xmk yhl lew
lkx: nel
kfd: muz
dki: iai hsb
klq: muw hmq zhc jrd
dyd: xbf ssk
udz: xxu
jzn: qgu sxg noc
hec: fww bat
eqk: reo
awk: frv
ayk: hii pqr
nyv: fdt nel
xvf: exv nam pnz
tfk: ggv hug
hmq: lgu opx def ijp wnx
ofu: rka
wpo: bat rps
bww: hug hns ggv
hty: nel fdt
gle: you mkd
yxp: djr uen zgn
hzi: mkd
bqe: civ
vvl: lew yhl
ijg: fnl abq fvp
quk: ihs pic klq
yri: dgv
cpf: tgc hty gvc
ghy: hzi fpp exo
ztw: rps
hns: mkd zwp
fhi: ulq ztw spt
sio: tfk dac cjb bww
lrt: aug tpn pde ynk mre rlb zzw zsz nvj wwt nbn mri opp ljs sft mbs dpb evs
fxc: gxj rfg evf can
aug: qec
rlb: ngp
hvn: hdd
wfc: mar
cfb: pmx ado qlw
wcz: jcf cvh koy
vkf: hfi qgb
pzy: jmw kag
gux: foc
yht: uzo ffx vox
xma: djr zgn uen
szz: hdd pbj iai hsb
bbc: zgn djr uen
aac: out
bwp: bat rps
gkt: ddt
qhf: rps
kag: you mkd
uzo: lgu
mnu: dtu lex
utz: wqy plv omh
xet: doo smd